StageNumber,2
//
ZNumber,0
MapData,1,1,1,1,1,1,1,1,1,1,1,1
MapData,1,0,0,0,0,0,0,0,0,0,0,1
MapData,1,0,0,0,0,0,0,0,0,0,0,1
MapData,1,0,0,0,0,0,0,0,0,0,0,1
MapData,1,0,0,0,0,0,0,0,0,0,0,1
MapData,1,0,0,0,0,0,0,0,0,0,0,1
MapData,1,0,0,0,0,1,0,0,0,0,0,1
MapData,1,0,0,0,1,0,0,0,0,0,0,1
MapData,1,0,0,1,0,0,0,0,0,0,0,1
MapData,1,0,1,0,0,0,0,0,0,0,0,1
MapData,1,1,0,0,0,0,0,0,0,0,0,1
MapData,1,1,1,1,1,1,1,1,1,1,1,1
//
ZNumber,1
MapData,1,1,1,1,1,1,1,1,1,1,1,1
MapData,1,1,1,1,1,1,1,1,1,1,1,1
MapData,1,1,1,1,1,1,1,1,1,1,1,1
MapData,1,1,1,1,1,1,1,1,1,1,1,1
MapData,1,1,1,1,1,1,1,1,1,1,1,1
MapData,1,1,1,1,1,1,1,1,1,1,1,1
MapData,1,1,1,1,1,1,1,1,1,1,1,1
MapData,1,1,1,1,1,1,1,1,1,1,1,1
MapData,1,1,1,1,1,1,1,1,1,1,1,1
MapData,1,1,1,1,1,1,1,1,1,1,1,1
MapData,1,1,1,1,1,1,1,1,1,1,1,1
MapData,1,1,1,1,1,1,1,1,1,1,1,1
